W W W W W W W W W W W W W W W W W W W W W W W W W
W 0 0 0 0 0 0 W 0 0 0 W c W 0 0 0 W 0 0 0 0 0 0 W
W 0 y 0 0 c 0 W 0 0 0 W r W 0 0 0 W 0 c 0 0 g 0 W
W 0 0 0 0 0 0 W 0 0 0 W G W 0 0 0 W 0 0 0 0 0 0 W
W 0 c 0 0 c 0 Y 0 c 0 W G W 0 c 0 Y 0 c 0 0 c 0 W
W 0 0 0 0 0 0 W 0 0 0 W G W 0 0 0 W 0 0 0 0 0 0 W
W 0 g 0 0 c 0 W 0 0 0 W G W 0 0 0 W 0 c 0 0 y 0 W
W 0 0 0 0 0 0 W 0 0 0 0 0 0 0 0 0 W 0 0 0 0 0 0 W
W W W W W W W W 0 0 0 0 0 0 0 0 0 W W W W W W W W
W 0 0 0 0 0 0 0 0 0 0 0 y 0 0 0 0 0 0 0 0 0 0 0 W
W 0 c 0 0 c 0 0 0 0 0 0 0 0 0 0 0 0 0 c 0 0 c 0 W
W 0 0 0 0 0 0 0 0 c 0 0 0 0 0 c 0 0 0 0 0 0 0 0 W
W 0 c 0 0 c 0 0 0 0 0 0 g 0 0 0 0 0 0 c 0 0 c 0 W
W 0 0 0 0 0 0 0 0 0 0 0 0 0 0 0 0 0 0 0 0 0 0 0 W
W 0 c 0 0 c 0 0 0 0 0 0 C 0 0 0 0 0 0 c 0 0 W R W
W 0 0 0 0 0 0 0 0 0 0 0 0 0 0 0 0 0 0 0 0 0 W b W
W B W W W W W W 0 0 0 0 0 0 0 0 0 W W W W W W G W
W g W W W W W W 0 c 0 0 0 0 0 c 0 W W W W W W r W
W R W W W W W W 0 0 0 0 0 0 0 0 0 W W W W W W B W
W b W W W W W W W W W W Y W W W W W W W W W W g W
W G W W W W W W 0 0 0 0 0 0 0 0 0 W W W W W W B W
W b W W W W W W 0 0 0 0 0 0 0 0 0 W W W W W W r W
W R W W W W W W 0 c 0 y 0 g 0 c 0 W W W W W W w W
W c W W W W W W 0 0 0 0 0 0 0 0 0 W W W W W W E W
W W W W W W W W W W W W W W W W W W W W W W W W W