W W W W W W W W W W W W W W W W W W W W W W W W W
W 0 0 0 0 0 0 W W W W W E W W W W W 0 0 0 0 0 0 W
W 0 c 0 0 0 0 W W W W W w W W W W W 0 0 0 0 c 0 W
W 0 0 0 0 0 0 W 0 0 0 0 0 0 0 0 0 W 0 0 0 0 0 0 W
W 0 0 b 0 0 0 Y 0 c 0 0 0 0 0 c 0 B 0 0 0 y 0 0 W
W 0 0 0 0 0 0 W 0 0 0 0 r 0 0 0 0 W 0 0 0 0 0 0 W
W 0 c 0 0 0 0 W 0 0 0 0 0 0 0 0 0 W 0 0 0 0 c 0 W
W 0 0 0 0 0 0 W 0 0 0 0 0 0 0 0 0 W 0 0 0 0 0 0 W
W W W W W W W W 0 0 0 0 0 0 0 0 0 W W W W W W W W
W 0 0 0 0 0 0 W 0 0 0 0 0 0 0 0 0 W 0 0 0 0 0 0 W
W 0 c 0 0 0 0 W 0 0 0 0 0 0 0 0 0 W 0 0 0 0 c 0 W
W 0 0 0 0 0 0 W 0 c 0 0 C 0 0 c 0 W 0 0 0 0 0 0 W
W 0 0 b 0 0 0 R 0 0 0 0 0 0 0 0 0 G 0 0 0 r 0 0 W
W 0 0 0 0 0 0 W 0 0 0 0 0 0 0 0 0 W 0 0 0 0 0 0 W
W 0 c 0 0 0 0 W 0 0 0 0 0 0 0 0 0 W 0 0 0 0 c 0 W
W 0 0 0 0 0 0 W 0 0 0 0 0 0 0 0 0 W 0 0 0 0 0 0 W
W W W W W W W W 0 0 0 0 0 0 0 0 0 W W W W W W W W
W 0 0 0 0 0 0 W 0 c 0 0 0 0 0 c 0 W 0 0 0 0 0 0 W
W 0 c 0 0 0 0 B 0 0 0 0 0 0 0 0 0 R 0 0 0 0 c 0 W
W 0 0 0 0 0 0 W W W W W Y W W W W W 0 0 0 0 0 0 W
W 0 0 0 0 0 0 W 0 0 0 0 0 0 0 0 0 W 0 0 0 0 0 0 W
W 0 0 0 y 0 0 W 0 0 0 0 0 0 0 0 0 W 0 0 y 0 0 0 W
W 0 c 0 0 0 0 W 0 c 0 0 g 0 0 c 0 W 0 0 0 0 c 0 W
W 0 0 0 0 0 0 W 0 0 0 0 0 0 0 0 0 W 0 0 0 0 0 0 W
W W W W W W W W W W W W W W W W W W W W W W W W W